{
  "spawn": {"x": 1, "y": 1, "direction": "right"},
  "stroke": 26,
  "dialogs": ["dialog.game.level_32_1"],
  "tiles": [
    "beach",
    "ice",
    "lava",
    "lightning",
    "purple:1",
    "purple:2",
    "purple:3",
    "red:1",
    "red:2"
  ],
  "map": [
    [0, 0, 3, 3, 8, 3, 8, 3, 1],
    [2, 0, 0, 3, 3, 3, 3, 3, 3],
    [6, 2, 0, 3, 3, 3, 8, 9, 3],
    [2, 2, 0, 0, 9, 3, 3, 3, 9],
    [2, 2, 6, 0, 4, 0, 9, 3, 3],
    [2, 2, 2, 2, 2, 0, 0, 9, 8],
    [2, 2, 7, 2, 2, 5, 0, 3, 3],
    [2, 5, 2, 2, 2, 2, 0, 0, 3],
    [1, 2, 2, 2, 2, 2, 7, 0, 0]
  ]
}