{
  "spawn": {"x": 2, "y": 1, "direction": "up"},
  "life": 1,
  "stroke": 58,
  "tiles": ["beach", "blue:10", "ice", "lava"],
  "map": [
    [1, 1, 1, 1, 1, 1, 1, 0, 0],
    [1, 0, 1, 0, 1, 0, 1, 1, 1],
    [1, 1, 1, 0, 0, 0, 1, 0, 1],
    [0, 0, 1, 0, 1, 0, 1, 0, 0],
    [1, 1, 1, 1, 1, 1, 1, 1, 1],
    [1, 0, 1, 0, 1, 0, 0, 0, 1],
    [0, 0, 0, 0, 1, 0, 1, 0, 1],
    [4, 3, 3, 1, 1, 1, 1, 1, 1],
    [0, 2, 0, 0, 1, 0, 0, 0, 0]
  ]
}