{
	"spawn": {"x": 1, "y": 9},
	"dialogs": [
		"Niveau 11<br/>La grotte de glace"
	],
	"tiles": ["beach", "ice", "grass", "lightning", "teleport", "red:2"],
	"map": [
		[3, 3, 2, 4, 3, 3, 3, 3, 1],
		[2, 2, 0, 2, 2, 2, 2, 2, 4],
		[2, 2, 2, 2, 2, 2, 0, 2, 4],
		[2, 0, 2, 2, 0, 2, 0, 2, 4],
		[4, 2, 2, 0, 1, 4, 2, 2, 4],
		[4, 2, 2, 2, 0, 0, 2, 2, 4],
		[4, 2, 0, 2, 2, 0, 2, 0, 4],
		[4, 1, 5, 0, 5, 2, 2, 6, 4],
		[4, 4, 4, 4, 4, 4, 4, 4, 4]
	]
}
