{
  "spawn": {"x": 5, "y": 1, "direction": "up"},
  "life": 1,
  "stroke": 41,
  "tiles": [
    "beach",
    "blue:2",
    "grass",
    "ice",
    "lava",
    "red:2",
    "teleport:1:2",
    "teleport:2:1"
  ],
  "map": [
    [7, 1, 5, 5, 1, 5, 5, 0, 8],
    [0, 4, 4, 5, 5, 5, 4, 1, 4],
    [4, 4, 4, 0, 5, 1, 4, 4, 0],
    [4, 0, 6, 4, 4, 4, 0, 4, 4],
    [4, 4, 4, 0, 4, 4, 0, 4, 0],
    [0, 1, 4, 4, 0, 4, 4, 1, 4],
    [1, 0, 0, 4, 4, 4, 4, 0, 4],
    [4, 4, 4, 4, 4, 0, 4, 4, 4],
    [3, 3, 3, 0, 2, 3, 3, 0, 1]
  ]
}